gj_act_gold_barometer	lc_gold_weekly_conf
gj_g2010_trad_time	lc_trade_time_conf
gj_g2099_act_code_flow_rel	lc_activity_flow_conf
prod_new_module_top	bd_prod_new_module_top
pro_label100	cp_prod_label100
gj_g2010_prod_info_base	gj_g2010_prod_info_base
gj_g2010_manual_prod_info	gj_g2010_manual_prod_info
sale_reminder_conf	lc_sale_reminder_api
pro_fund_bas_info	cp_fund_bas_info
prod_fund_manager_pic	cp_fund_manager_pic
gj_prod_net_value	cp_net_value
gj_pro_fndcn_is_awardinfo	cp_fndcn_is_awardinfo
jhzt_config_info_detail	jh_config_info_detail
jhzt_forum_post	jh_forum_post
zxzx_fndcn_zx_info	zx_fndcn_zx_info
mng_pfmance_latest_group	cp_mng_pfmance_latest_group
fund_mng_info	cp_fund_mng_info
fund_mng_holder	cp_fund_mng_holder
mng_pfmance_latest	cp_mng_pfmance_latest
gj_t_pro_holderall_all	cp_t_pro_holderall_all
gj_t_pro_holderall	cp_t_pro_holderall
fund_manage_opinion	lc_fund_manage_opinion
fund_mng_of_prod	cp_fund_mng_of_prod
gj_pdc_expected_return	cp_pdc_expected_return
gj_xinke_list_prod	lc_xinke_list_prod
gj_g2010_item_info	lc_item_info
gj_g2010_item_prod_info_sh	lc_item_prod_info_sh
gj_g2010_code_user_rule_info	lc_code_user_rule_info
gj_g2010_second_item_prod_info	lc_second_item_prod_info
gj_g2010_item_news_info_sh	lc_item_news_info_sh
gj_g2010_news_info	lc_news_info
gj_g2010_item_news_info	lc_item_news_info
gj_g2010_item_news_rule_sh	lc_item_news_rule_sh
gj_g2010_news_rule	lc_news_rule
gj_g2010_item_news_rule	lc_item_news_rule
gj_g2010_advertise_info	lc_advertise_info
gj_g2010_advertise_info_sh	lc_advertise_info_sh
gj_g2010_item_info_sh	lc_item_info_sh
gj_g2010_manual_prod_info_sh	gj_g2010_manual_prod_info_sh
gj_g2010_manual_prod_info	gj_g2010_manual_prod_info
gj_g2010_product_mould_info	lc_product_mould_info
gj_g2010_code_type_info	lc_code_type_info
prod_invest_module_top	bd_prod_invest_module_top
prod_invest_module_rank	bd_prod_invest_module_rank
lc_lmsp_calendar	lc_lmsp_calendar
prod_invest_module_top_backups	bd_prod_invest_module_top_backups
idx_makt_quot_partition(idx_makt_quot_rate)	cp_idx_makt_quot_partition
g_p_user_news2em	kf_user_news2em
gj_zx_fndcn_unit_nav	zx_fndcn_unit_nav
gj_zx_cdsy_corres	zx_cdsy_corres
etf_configuration	lc_etf_configuration
prod_invest_module_code	lc_prod_invest_module_code
gj_g2010_prod_info_base_extend	gj_g2010_prod_info_base_extend
gj_otc_product	cp_otc_product
gj_g9010_suitably_info	if_suitably_info
gj_fixed_list_prod	lc_fixed_list_prod
gj_g2010_index_data	gj_g2010_index_data
gj_g2082_stra_prod_rel_info	gj_g2082_stra_prod_rel_info
gj_otc_idx_invest_config	lc_idx_invest_config
g_p_user_quant2big	kf_user_quant2big
junhong_evt_prod_read_detail	bd_jh_evt_prod_read_detail
prod_div_spl	cp_prod_div_spl
pro_fund_ben	cp_pro_fund_ben
invest_stock	cp_invest_stock
gj_name_py_info	cp_name_py_info
pro_nv_nav	cp_pro_nv_nav
gj_pro_mng_pfmance	cp_pro_mng_pfmance
g2020_pro_pri_info	cp_pro_pri_info
gj_2020_item_thumb_up	if_item_thumb_up
gj_select_prod_100	lc_select_prod_100
gj_select_tab_100	lc_select_tab_100
prod_fund_manager	cp_fund_manager
pro_fund_fee	cp_pro_fund_fee
mng_pfmance_total	cp_mng_pfmance_total
pro_cpdm_kfr_yyrl	cp_pro_cpdm_kfr_yyrl
aaahaa01	cp_aaahaa01
t_fundcompanyinfo_es	cp_t_fundcompanyinfo_es
pro_org_bank_view	cp_pro_org_bank_view
prod_fund_manager	cp_prod_fund_manager
pro_fund_url	cp_pro_fund_url
pro_fund_pi_indu	cp_pro_fund_pi_indu
pro_val_noncurrency	cp_pro_val_noncurrency
pro_fndcn_is_awardinfo	cp_pro_fndcn_is_awardinfo
t_north_bound_fund_pool	cp_t_north_bound_fund_pool
pro_fund_notice	cp_pro_fund_notice
pro_own_bas_info	cp_pro_own_bas_info
t_full_pension_info	cp_t_full_pension_info
prod_thb	cp_prod_thb
pro_quot_score	cp_pro_quot_score
vw_pdc_expected_return	cp_vw_pdc_expected_return
prod_pri	cp_prod_pri
pro_own_notice	cp_pro_own_notice
pro_fund_ben	cp_pro_fund_ben
t_fundinfo_perf	cp_t_fundinfo_perf
pro_zg_profitschema	cp_pro_zg_profitschema
assetalloct	cp_assetalloct
asset_conf_alloc	cp_asset_conf_alloc
pro_pri_info	cp_pro_pri_info
pro_own_view	cp_pro_own_view
pro_publicity_materials	cp_pro_publicity_materials
t_pro_holderall	cp_t_pro_holderall
jzjy_ofcode_taxdeferred	cp_jzjy_ofcode_taxdeferred
pro_fund_view	cp_pro_fund_view
pro_merch_view	cp_pro_merch_view
pro_mng_pfmance	cp_pro_mng_pfmance
pro_nv_nav	cp_pro_nv_nav
pro_fndcn_bs_atype	cp_pro_fndcn_bs_atype
vpdtgdyhsomefund_gtja	cp_vpdtgdyhsomefund_gtja
invest_stock	cp_invest_stock
t_pro_bcastall	cp_t_pro_bcastall
pro_fund_fee	cp_pro_fund_fee_temp
pro_fund_fee	cp_pro_fund_fee
pro_lcjj_view	cp_pro_lcjj_view
fndcn_fund_mng	cp_fndcn_fund_mng
prod_reserve	cp_prod_reserve
fund_mng_assetamt	cp_fund_mng_assetamt
pro_fundbaseinfo	cp_pro_fundbaseinfo
pro_nav_view	cp_pro_nav_view
prod_ownotc	cp_prod_ownotc
com_info_view	cp_com_info_view
pro_fund_bas_info	cp_pro_fund_bas_info
prod_otc	cp_prod_otc
zg_vw_pdc_expected_return	cp_zg_vw_pdc_expected_return
prod_bank	cp_prod_bank
pro_quot_avgscore	cp_pro_quot_avgscore
prd_asset_report_prod_info	cp_prd_asset_report_prod_info
prod_net_value	cp_prod_net_value
income_link_target	cp_income_link_target
pro_customize	cp_pro_customize
pro_cdsy_pictures	cp_pro_cdsy_pictures
pro_ownotc_view	cp_pro_ownotc_view
pro_own_manager	cp_pro_own_manager
pro_private_url	cp_pro_private_url
pro_thb	cp_pro_thb
prod_div_spl	cp_prod_div_spl
pro_fund_rat_rk_view	cp_pro_fund_rat_rk_view
pro_own_fee	cp_pro_own_fee
jzqs_oftacodechange	cp_jzqs_oftacodechange
asset_conf	cp_asset_conf
pro_select_100	cp_pro_select_100
prod_stktrd	cp_prod_stktrd
pro_pri_manager	cp_pro_pri_manager
pro_fndcn_dr_techindex	cp_pro_fndcn_dr_techindex
pro_diag_score	cp_pro_diag_score
bigdata_bs_ofinfo	cp_bigdata_bs_ofinfo
firk_view	cp_firk_view
prod_div_send	cp_prod_div_send
t_fundinfo_es	cp_t_fundinfo_es
pro_fndcn_unit_nav_idx_new_his	cp_pro_fndcn_unit_nav_idx_new_his
pro_doublerecord_view	cp_pro_doublerecord_view
fundclass_view	cp_fundclass_view
idx_makt_quot	cp_idx_makt_quot
jzjy_org	cp_jzjy_org
pri_fundtotvol	cp_pri_fundtotvol
bigdata_fndcn_dr_emsypmall	cp_bigdata_fndcn_dr_emsypmall
tq_sk_basicinfo	zx_tq_sk_basicinfo
shzq_gj_fund_interval_indicator	zx_shzq_gj_fund_interval_indicator
shzq_gj_manager_scenario_analysis	zx_shzq_gj_manager_scenario_analysis
cdsy_corres	zx_cdsy_corres
shzq_gj_fund_rating	zx_shzq_gj_fund_rating
shzq_gj_fund_holding_style_ratio	zx_shzq_gj_fund_holding_style_ratio
fund_nv_nv	zx_fund_nv_nv
shzq_gj_fund_info	zx_shzq_gj_fund_info
cdsy_secucode	zx_cdsy_secucode
fndcn_bs_ofinfo	zx_fndcn_bs_ofinfo
shzq_gj_fund_in_office	zx_shzq_gj_fund_in_office
shzq_gj_manager_invest_style	zx_shzq_gj_manager_invest_style
shzq_gj_fund_profit_probability_his	zx_shzq_gj_fund_profit_probability_his
shzq_gj_fund_scenario_analysis	zx_shzq_gj_fund_scenario_analysis
fndcn_nv_nav	zx_fndcn_nv_nav
fndcn_bas_info	zx_fndcn_bas_info
shzq_gj_fund_cross_scene_er	zx_shzq_gj_fund_cross_scene_er
shzq_gj_manager_interval_indicator	zx_shzq_gj_manager_interval_indicator
shzq_gj_fund_holding_style	zx_shzq_gj_fund_holding_style
shzq_gj_fund_manager_rating	zx_shzq_gj_fund_manager_rating
fndcn_em_appfundtype	zx_fndcn_em_appfundtype
fndcn_dr_fundnv	zx_fndcn_dr_fundnv
shzq_gj_fund_brinson_attribution	zx_shzq_gj_fund_brinson_attribution
fndcn_unit_nav	zx_fndcn_unit_nav
shzq_gj_fund_invest_style	zx_shzq_gj_fund_invest_style
view_forum_post	jh_view_forum_post
user_forum.view_config_info	jh_view_config_info
v_cus_redemption_request	sz_v_cus_redemption_request
v_pro_robots_quote	sz_v_pro_robots_quote
v_questionnaire	sz_v_questionnaire
v_pro_robots_benchmark	sz_v_pro_robots_benchmark
v_pro_robots_annex_relation	sz_v_pro_robots_annex_relation
v_strategy_report	sz_v_strategy_report
pswms_flows.flow_doc_srkh_invest	sz_flow_doc_srkh_invest
v_fund_pool	sz_v_fund_pool
v_robot_text	sz_v_robot_text
v_pro_robot_product_adjust	sz_v_pro_robot_product_adjust
pri_asset_data	sz_pri_asset_data
v_pro_robots_holding	sz_v_pro_robots_holding
v_pro_robots	sz_v_pro_robots
rx_position_data	sz_rx_position_data
wzsj_cust_info	nonono_wzsj_cust_info
user_basic_info	nonono_user_basic_info
br_offshoot	nonono_br_offshoot
em_role_user_info	nonono_em_role_user_info
vprodquot	og_vprodquot
vprodbranchzone	og_vprodbranchzone
gj_g2010_trad_time	lc_trade_time_conf
gj_g2010_prod_and_mark	lc_prod_and_mark
gj_g2010_trade_rule_info	lc_trade_rule_info
gj_g2010_home_page_redesign	lc_home_page_redesign
gj_g2010_manual_prod_info	gj_g2010_manual_prod_info
big_dictvalue	lc_big_dictvalue
ebuy_buy_prod	lc_ebuy_buy_prod
ebuy_free_prod	lc_ebuy_free_prod
ebuy_picture	lc_ebuy_picture
etf_configuration	lc_etf_configuration
fund_manage_opinion	lc_fund_manage_opinion
g2021_invest_chance	lc_invest_chance
g2021_invest_fund	lc_invest_fund
g2021_invest_hot_event	lc_invest_hot_event
g2021_invest_module	lc_invest_module
g2021_invest_occupotion	lc_invest_occupotion
g2021_invest_prod	lc_invest_prod
g2021_invest_read	lc_invest_read
g2021_invest_video	lc_invest_video
g2021_invest_weekly_report	lc_invest_weekly_report
g2022_fixed_income_occupation	lc_fixed_income_occupation
g2022_fixed_income_prod	lc_fixed_income_prod
gj_2019_financial_task_config	lc_financial_task_config
gj_2019_share_mini_program	lc_share_mini_program
gj_2021_gas_station818	lc_gas_station818
gj_2021_home_page_jxt	lc_home_page_jxt
gj_cfh_homepage_info	lc_cfh_homepage_info
gj_esb_login_info	lc_esb_login_info
gj_fixed_list_info	lc_fixed_list_info
gj_fixed_list_prod	lc_fixed_list_prod
gj_g2010_code_type_info	lc_code_type_info
gj_g2010_code_user_rule_info	lc_code_user_rule_info
gj_g2010_cust_dmp_info	lc_cust_dmp_info
gj_g2010_cust_dmp_info_temp	lc_cust_dmp_info_temp
gj_g2010_hot_words	lc_hot_words
gj_fixed_list_rule	lc_fixed_list_rule
gj_fycj_prizecounter	lc_fycj_prizecounter
gj_g2010_818wish_scene	lc_818wish_scene
gj_g2010_818wish_wall	lc_818wish_wall
gj_g2010_advertise_info	lc_advertise_info
gj_g2010_item_info	lc_item_info
gj_g2010_item_news_info	lc_item_news_info
gj_g2010_item_news_rule	lc_item_news_rule
gj_g2010_item_rule_info	lc_item_rule_info
gj_g2010_manual_dmp_tag	lc_manual_dmp_tag
gj_g2010_news_info	lc_news_info
gj_g2010_news_info_prod	lc_news_info_prod
gj_g2010_news_rule	lc_news_rule
gj_g2010_noun_explain	lc_noun_explain
gj_g2010_prod_set_asset	lc_prod_set_asset
gj_g2010_prod_set_asset_his	lc_prod_set_asset_his
gj_g2010_prod_set_income_info	lc_prod_set_income_info
gj_g2010_prod_set_info	lc_prod_set_info
gj_g2010_prod_set_report	lc_prod_set_report
gj_g2010_prod_set_transferwh	lc_prod_set_transferwh
gj_g2010_prod_set_whinfo	lc_prod_set_whinfo
gj_g2010_prod_set_whinfo_his	lc_prod_set_whinfo_his
gj_g2010_product_expire_remind	lc_product_expire_remind
gj_g2010_product_mould_info	lc_product_mould_info
gj_g2010_rule_info	lc_rule_info
gj_g2010_second_item_prod_info	lc_second_item_prod_info
gj_g2010_thb_trade_rule_info	lc_thb_trade_rule_info
gj_g2010_thbvip_config	lc_thbvip_config
gj_g2010_topic_info	lc_topic_info
gj_g2010_trad_rule_info	lc_trad_rule_info
gj_g2010_user_rule_match_info	lc_user_rule_match_info
gj_g2010_user_rule_match_temp	lc_user_rule_match_temp
gj_g2010_vip_config	lc_vip_config
gj_g2019_marketing_construct	lc_marketing_construct
gj_g2021_list_info	lc_list_info
gj_g2021_propagate_material	lc_propagate_material
gj_g2023_agreement	lc_agreement
gj_g2023_ebuy	lc_ebuy
gj_g2050_esb_funcdetail	lc_esb_funcdetail
gj_g2050_esb_funclist	lc_esb_funclist
gj_g2060_prod_store_info	lc_prod_store_info
gj_g2070_guess_rd_info	lc_guess_rd_info
gj_g2070_notice_info	lc_notice_info
gj_g2070_page_info	lc_page_info
gj_g2082_invest_img_info	lc_invest_img_info
gj_g2082_stra_prod_rel_info	lc_stra_prod_rel_info
gj_g2082_strategy_info	lc_strategy_info
gj_g2099_act_code_flow_rel	lc_act_code_flow_rel
gj_g3010_prod_deptnum_info	lc_prod_deptnum_info
gj_g3020_prod_info	lc_prod_info
gj_g3020_vote_info	lc_vote_info
gj_g9010_icon_url_turns	lc_icon_url_turns
gj_g9010_time_manager	lc_time_manager
gj_otc_big_cust_pro	lc_otc_big_cust_pro
gj_otc_idx_invest_config	lc_otc_idx_invest_config
gj_otc_product_sell	lc_otc_product_sell
gj_otc_trade_product_can	lc_otc_trade_product_can
gj_pro_select_100	lc_pro_select_100
gj_select_prod_100	lc_select_prod_100
gj_select_tab_100	lc_select_tab_100
gj_xinke_list_prod	lc_xinke_list_prod
gj2023_pension_account	lc_pension_account
jy_fund_manager_info	lc_jy_fund_manager_info
jy_fund_manager_prod	lc_jy_fund_manager_prod
news_prod_cursor	lc_news_prod_cursor
prod_invest_module_code	lc_prod_invest_module_code
xjb_configuration_item	lc_xjb_configuration_item
fund_manage_label	lc_fund_manage_label
gj_g2010_ad_info_his	lc_ad_info_his
gj_g2010_dmp_tag	lc_dmp_tag
gj_g2010_dmp_tag_info	lc_dmp_tag_info
gj_g2010_dmp_tag_info_ins	lc_dmp_tag_info_ins
gj_g2010_dmp_tag_kyp	lc_dmp_tag_kyp
gj_g2010_fincard_tag_info	lc_fincard_tag_info
gj_g2010_fintask_tag_info	lc_fintask_tag_info
gj_g2010_function_info	lc_function_info
gj_g2010_item_info_his	lc_item_info_his
gj_g2010_item_info_mb_pri	lc_item_info_mb_pri
gj_g2010_item_info_mb_pub	lc_item_info_mb_pub
gj_g2010_mould_field_info	lc_mould_field_info
gj_g2010_news_featrue_middle	lc_news_featrue_middle
gj_g2010_oper_record	lc_oper_record
gj_g2010_org_dep_info	lc_org_dep_info
gj_g2010_prod_child_bank_info	lc_prod_child_bank_info
gj_g2010_prod_detail	lc_prod_detail
gj_g2010_prod_feature	lc_prod_feature
gj_g2010_prod_info_his	lc_prod_info_his
gj_g2010_prod_trustee_bank	lc_prod_trustee_bank
gj_g2010_trad_time_record	lc_trad_time_record
gj_g2010_user_policy_detail	lc_user_policy_detail
gj_g2010_user_policy_info	lc_user_policy_info
gj_g2010_virtual_prod_info	lc_virtual_prod_info
gj_g2019_mallwarning_info	lc_mallwarning_info
gj_g2019_mallwarning_prod	lc_mallwarning_prod
gj_g2020_auth_config_info	lc_auth_config_info
gj_g2020_material_info	lc_material_info
gj_g2020_material_template	lc_material_template
gj_g2020_otc_export_log	lc_otc_export_log
gj_g2020_work_info	lc_work_info
gj_g2060_rule_info	lc_rule_info_lst
gj_g2082_minus_earning_rate	lc_minus_earning_rate
gj_g2082_stra_rule_info	lc_stra_rule_info
gj_g3010_prod_do_info	lc_prod_do_info
gj_g3010_wallet_reset	lc_wallet_reset
gj_g3020_prod_target_info	lc_prod_target_info
gj_interface_problem_analy	lc_interface_problem_analy
gj_otc_big_cust_pro_tp	lc_otc_big_cust_pro_tp
gj_pro_publicity_materials_log	lc_pro_publicity_materials_log
jh2022_service_focus_comp_sh	jhh_service_focus_comp_sh
fund_user_role	jhh_fund_user_role
jh2022_service_card_comp	jhh_service_card_comp
jh2022_new_info_comp	jhh_new_info_comp
jh2022_service_focus_comp	jhh_service_focus_comp
jh2022_prod_menu_comp_sh	jhh_prod_menu_comp_sh
jh2022_bottom_menu_comp_sh	jhh_bottom_menu_comp_sh
jh2022_tab_card_comp_sh	jhh_tab_card_comp_sh
jh2022_video_card_comp	jhh_video_card_comp
jh2022_video_card_comp_sh	jhh_video_card_comp_sh
material_pic_msg	jhh_material_pic_msg
material_pic	jhh_material_pic
material_pic_msg_rich	jhh_material_pic_msg_rich
material_pic_msg_sh	jhh_material_pic_msg_sh
fund_user	jhh_fund_user
jh2022_fund_card_comp_sh	jhh_fund_card_comp_sh
jh2022_fund_card_comp	jhh_fund_card_comp
jh2022_prod_list_comp	jhh_prod_list_comp
jh2022_pic_carousel_comp	jhh_pic_carousel_comp
jh2022_tab_card_comp	jhh_tab_card_comp
jh2022_exposure_comp	jhh_exposure_comp
jh2022_service_card_comp_sh	jhh_service_card_comp_sh
jh2022_exposure_comp_sh	jhh_exposure_comp_sh
jh2022_pic_carousel_comp_sh	jhh_pic_carousel_comp_sh
jh2022_prod_menu_comp	jhh_prod_menu_comp
jh2022_new_info_comp_sh	jhh_new_info_comp_sh
jh2022_shop_info	jhh_shop_info
jh2022_bottom_menu_comp	jhh_bottom_menu_comp
g2010_jzjy_funddata	kfk_jzjy_funddata
GJ_G2010_RULE_PROD_DMP_ASK	lc_rule_prod_dmp_ask
GJ_G2010_RULE_PROD_DMP	lc_rule_prod_dmp
GJ_OTC_PRODUCT_CAN_BUY	if_otc_product_can_buy
GJ_GDYH_PRODUCT_BASE	if_gdyh_product_base
GJ_G2010_12210305	if_12210305
GJ_G2010_12005204	if_12005204
GJ_G4030_HGT_RATE_QUERY	if_hgt_rate_query
GJ_T2_10602309	if_10602309
gj_index_fluctuate_prod	lc_index_fluctuate_prod
gj_cfh_homepage_info_sh	lc_cfh_homepage_info_sh
LMSP_DATADICT	LMSP_DATADICT
LMSP_DATADICTTYPE	LMSP_DATADICTTYPE
LC_HOMEPAGE_ICON_INFO	LC_HOMEPAGE_ICON_INFO
L_AUTH_LIMIT	L_AUTH_LIMIT
L_GROUP	L_GROUP
L_GROUP_ROLE_REL	L_GROUP_ROLE_REL
L_MEMBER	L_MEMBER
L_MEMBER_GROUP_REL	L_MEMBER_GROUP_REL
L_MEMBER_ORGANIZATION_REL	L_MEMBER_ORGANIZATION_REL
L_MEMBER_POSITION_REL	L_MEMBER_POSITION_REL
L_MEMBER_ROLE_REL	L_MEMBER_ROLE_REL
L_ORGANIZATION	L_ORGANIZATION
L_POSITION	L_POSITION
L_POSITION_ROLE_REL	L_POSITION_ROLE_REL
L_ROLE	L_ROLE
L_ROLE_HIERARCHY_REL	L_ROLE_HIERARCHY_REL
L_USER	L_USER
LMSP_AUTHORITY	LMSP_AUTHORITY
LMSP_BLOB	LMSP_BLOB
LMSP_BO_ACCESS	LMSP_BO_ACCESS
LMSP_CALENDAR	LMSP_CALENDAR
LMSP_COL_DATAAUTH	LMSP_COL_DATAAUTH
LMSP_COMINFO	LMSP_COMINFO
LMSP_DATAAUTH	LMSP_DATAAUTH
LMSP_DATADICT	LMSP_DATADICT
LMSP_DATADICTTYPE	LMSP_DATADICTTYPE
LMSP_DM_COL	LMSP_DM_COL
LMSP_DM_REL	LMSP_DM_REL
LMSP_DM_RELDTL	LMSP_DM_RELDTL
LMSP_DM_TABLE	LMSP_DM_TABLE
LMSP_FILE_ERROR	LMSP_FILE_ERROR
LMSP_FILE_VOLUMN	LMSP_FILE_VOLUMN
LMSP_GADGET	LMSP_GADGET
LMSP_HOME_MEM_REL	LMSP_HOME_MEM_REL
LMSP_HOME_SETTING	LMSP_HOME_SETTING
LMSP_LBPM_AGENT	LMSP_LBPM_AGENT
LMSP_LBPM_HISTINS	LMSP_LBPM_HISTINS
LMSP_LBPM_HISTINSPROP	LMSP_LBPM_HISTINSPROP
LMSP_LBPM_HISTSTEP	LMSP_LBPM_HISTSTEP
LMSP_LBPM_HISTTASK	LMSP_LBPM_HISTTASK
LMSP_LBPM_INSDEF	LMSP_LBPM_INSDEF
LMSP_LBPM_INSPROP	LMSP_LBPM_INSPROP
LMSP_LBPM_INSSTEP	LMSP_LBPM_INSSTEP
LMSP_LBPM_INSTASK	LMSP_LBPM_INSTASK
LMSP_LBPM_PDEF	LMSP_LBPM_PDEF
LMSP_LBPM_PDEFCON	LMSP_LBPM_PDEFCON
LMSP_LBPM_PINS	LMSP_LBPM_PINS
LMSP_LTIMERLOG	LMSP_LTIMERLOG
LMSP_LTIMERLOGHIST	LMSP_LTIMERLOGHIST
LMSP_LTIMERSET	LMSP_LTIMERSET
LMSP_LTIMERSETHIST	LMSP_LTIMERSETHIST
LMSP_MOM_MSG	LMSP_MOM_MSG
LMSP_MOM_MSGHIST	LMSP_MOM_MSGHIST
LMSP_MOM_MSGTPL	LMSP_MOM_MSGTPL
LMSP_RECORD	LMSP_RECORD
LMSP_REPORTWS_DEF	LMSP_REPORTWS_DEF
